      111111
      1000011
      1000001      111   111
      1000001      101      1
      1110001      111  
        10011           
    111110111111        
    100000000001
    1000000000011111111111111
    100001W100000000000000001
    1000011000001101010111001
    11000000000111010101 1001
    111000000111 1111111 10011      1     
    10101000111          11001     1      11111
    101001011    1   111111001    1           1 
    10010101        1100000001   111111   11111
  1110100101111111111000000001       1    1
 11000001000000000000000111111       1 	  11111
1100000010000000000000111
 1100000111111110111111
  1100011      101
   11111       111