      111111
      1000011
      1000001      111   111
      1000001      101      1
      1110001      111  
        10011           
    111110111111        
    100000000001
    1000000000011111111111111
    100001N100000000000000001
    1000011000001101010111001 
    11000000000111010101 1001 
     11000000111 1111111 1001 
      10000111           1001 
      111011    1   111111001 
      10001        1100000001 
  111110101111111111000000001 
 1100000100000000000000011111  
1100000010000000000000111
 1100000111111110111111
  1100011      101
   11111       111