      111111
      1000011
      10X0001      111   111
      1000001      1C1      1
      1110001      111  
        10011           
    11111CC11111        
    100000000001
    1000000000011111111111111
    100001W100000000000000001
    10000110000011C1C1O111001
    1100000000X111X10101 1001
    111000000111 1111111 10011      1     
    1X101000111          11001     1      11111
    1010C1011    1   111111001    1           1 
    10X10101        1100000001   111111   11111
  1110100101111111111000000001       1    1
 11000001000000000000000111111       1 	  11111
1100X00010000000000000111
 1100000111111110111111
  1100011      1X1
   11011       111
11111011111
100C00CCCC1
10C000000C1
1CCCC0CCCC1
100C00C0001
100C00CCCC1
11111111111
