111111111111111111111111111111
100000110000001100000110000001
100000110000000000000000000001
100010010011000000000000000001
100111110010100000000110000001
100000000010001100000110000001
100111000011111100000000000001
100001100000101100000100000001
101100001110010000000100000001
101100000000010000000110000001
1001000000000S0000000110000001
101100000000000000000110000001
101100000000000000000110000001
101100000000001100000000000001
101100000000001100000110000001
101100000000000000000110000001
101100000000001000000000000001
101100000000000000000110000001
101100000000001100000110000001
101100000000000000000110000001
101100000010001100000110000001
101100000010001100000110000001
111111111111111111111111111111
