11111
10001
10001
10101
11111
