11111
1S001
10001
10101
11111
