11111111111
10000010001
100001P1001
10110010001
10010000001
11111111111
