111111111111111
1X000X00X000001
10E000000X00001
10000X0000X0001
1X00000X0000001
100X00000XX0X01
1000100000X0001
101111100000011
101000100X00011
10X00X000010001
101000100010001
111111111111111
