11111111111
10000000001
10000000001
1011000P001
10010000001
11111111111
