111111111111111
1000XXX00000001
10E00XX00000001
10000X000000001
1000000X0X00001
100X00X00000001
100010000000001
10111110X00X011
101000100X00011
100000000010001
101000100010001
111111111111111
