11111111111111111
1X000X00X00000101
100000000X0E00101
10000X0000X000101
1X00000X00D000101
100X00000XX0X0101
1000100000X000101
10111110000001101
101000100X0001101
10X00X00001000101
10100010001000101
11111111111111111
