111111111111111
100000000000001
100000000000001
100000000000001
100000000000001
100000000000001
100010000000001
101111100000011
10100010N000011
100000000010001
101000100010001
111111111111111
