111111111111111
100000000000001
100000000000001
100000000000001
100000000000001
100000000000001
100000000000001
101100100000011
101100100000011
100100000010001
101100100010001
111111111111111
