11111111111
10000000001
10000001101
10000010001
10000000001
10000000001
100000P0001
10110010001
10010000001
11111111111
