   11111         11111
 11000001       10000011  111
1000000001     1000000001 101
100000000011 110000000001 111
100000S000001000000000001
 10000000000100000000001
  100000000010000000001
   1000000001000000001
    11000000000000011
1     1000001000001
       10000100001
        100010001  1
         1101011  101
           111     1