111111111111111
100000110000001
100010010011001
100111110010101
100000000010001
100111000011111
100001100000101
101100101110011
101100100000011
100100000010001
101100100010001
111111111111111
