SO img/tech_swall_64.xpm
WE img/tech_wwall_64.xpm
NO  	  img/tech_nwall_64.xpm
EA  img/tech_ewall_64.xpm

F 64,164,199
C 220,100,100

        1111111111111111111111111
        1000000000110000000000001
        1011000001110000000001001
        1001000000000000001000001
111111111011000001110000000000001
100000000000000000000000000011111
11110000000000000000000010001
111100000000000E0000010010001
10000000000000001101010000001
1100000111010101111101111000111
11110111 1110101 101111010001
11111111 1111111 111111111111
